9 9 9 9 9 9 9 9 9 9 9 9 9 9 9 9 9 9 9 9 9 9 9 9 9 9 9 9 9 9 9 9 9 9 9 9 9 9 9 9 9 9 9 9 9 9 9 9 9 9 9 9 9 9 9 9 9 9 9 9 9 9 9 9 9 9 9 9 9 9 
9 m 9 9 9 % 9 9 9 9 9 9 9 9 9 9 m 9 9 % 9 9 % 9 9 9 9 9 9 9 9 % 9 9 9 9 m 9 9 9 % 9 9 9 9 9 9 9 9 9 9 m 9 9 % 9 9 % 9 9 9 9 9 9 9 9 % 9 9 9 
9 9 9 9 9 9 9 9 9 9 9 m 9 9 % 9 9 9 9 9 9 9 9 9 9 9 m 9 9 % 9 9 m 9 9 9 9 9 9 9 9 9 9 9 9 9 m 9 9 % 9 9 9 9 9 9 9 9 9 9 9 m 9 9 % 9 9 m 9 9 
9 9 9 9 9 9 9 9 9 9 9 9 9 9 9 9 9 9 9 9 9 9 t t 9 9 9 9 9 9 9 9 9 9 9 9 9 9 9 9 9 9 9 9 9 9 9 9 9 9 9 9 9 9 9 9 9 9 9 9 9 9 9 9 9 9 9 9 9 9 
9 9 9 9 9 9 9 9 9 9 9 9 9 9 t t t t 9 9 9 t s s t t 9 9 9 9 9 9 9 9 9 9 9 9 9 9 9 9 9 t t t 9 9 9 9 9 9 9 9 9 9 9 t t t t t 9 9 9 9 9 9 9 9 
9 9 9 9 9 9 t t t t t t t t s s s s t t t s s s s s t t t 9 9 9 9 9 9 9 9 t t 9 9 t t s s s t t t 9 9 9 9 9 9 9 t s s s s s t t 9 9 9 9 9 9 
t t t t t t s s s s s s s s s s s s s s s s s s s s s s s t t t t t t t t s s t t s s s s s s s s t t t t t t t s s s s s s s s t t t t 9 9 
s s s s s s s s s s s s s s s s s s s s s s s s s s s s s s s s s s s s s s s s s s s s s s s s s s s s s s s s s s s s s s s s s s s s t t 